9
7
0 1 0 1 0 5 5 5 2 2 3 3 7 5 5 1
5 5 5 5 5 5 5 2 2 4 4 3 4 1 5 0
6 6 6 5 5 5 5 2 4 4 4 3 4 5 0 1
1 0 1 5 5 2 2 4 4 4 5 3 4 0 1 0
0 1 0 5 2 3 3 4 4 2 5 2 4 1 0 3
1 7 5 2 4 3 4 4 2 5 5 5 5 3 3 3
3 4 4 4 4 4 3 1 4 1 3 3 3 3 3 3
2 2 3 3 2 3 3 4 3 4 4 4 4 4 4 4