1
5
0 1 0 1 0 1 0 1 4 4 4 4 4 1 0 1
1 0 1 0 1 0 1 0 4 4 4 4 4 0 1 0
0 1 2 1 0 3 3 1 4 4 0 1 0 1 0 1
1 0 2 0 3 3 1 2 4 4 4 4 1 0 1 0
0 1 2 1 3 3 0 2 0 1 4 4 4 1 0 1
1 0 2 0 3 0 1 0 1 0 1 0 1 0 1 0
0 1 0 1 0 1 0 1 0 1 0 1 0 1 0 1
1 0 1 0 1 0 1 0 1 0 1 0 1 0 1 0