14
5
0 1 0 1 0 1 0 1 0 1 0 1 0 1 0 1
1 0 1 0 1 0 1 0 1 0 1 0 1 0 1 0
0 1 0 1 0 1 0 1 0 2 3 3 3 2 3 3
1 0 1 0 1 0 1 0 1 2 3 3 3 3 3 0
0 1 0 1 0 1 0 1 0 2 3 3 3 3 3 3
1 0 1 0 1 0 1 0 1 0 1 0 3 3 3 3
0 1 0 1 0 1 0 1 0 1 0 1 0 1 0 1
1 0 1 0 1 0 1 0 1 0 1 0 1 0 1 0