5
7
0 1 0 1 0 1 2 5 0 1 0 1 0 1 0 1
2 2 2 0 1 0 2 5 2 0 1 0 1 0 1 0
1 1 1 1 0 1 2 5 2 1 0 1 0 1 0 1
1 1 1 0 1 0 2 5 2 0 1 0 1 0 1 0
1 1 1 1 0 1 2 5 2 1 0 1 0 1 0 1
2 2 2 0 1 0 2 5 2 0 1 0 1 0 1 0
0 1 0 1 0 1 2 5 2 1 0 1 0 1 0 1
1 0 1 0 1 0 1 5 2 0 1 0 1 0 1 0