4
15
5 5 5 5 5 5 5 5 5 5 5 5 5 5 5 5
0 2 2 2 2 2 2 2 2 2 2 2 2 2 2 1
0 1 2 4 2 1 0 1 0 1 0 1 0 1 0 3
1 0 2 4 2 0 1 0 1 0 1 0 1 0 1 3
0 1 2 4 2 1 0 1 0 1 0 1 0 1 0 3
1 0 1 4 2 0 1 0 1 0 1 0 1 0 1 3
0 2 2 2 2 2 2 2 2 2 2 2 2 2 2 1
6 6 6 6 6 6 6 6 6 6 6 6 6 6 6 6