8
7
0 1 2 2 0 5 7 1 5 5 5 1 0 1 0 1
1 0 5 2 1 0 7 4 3 5 3 4 1 0 1 0
0 1 5 5 6 2 7 3 4 3 4 3 5 1 0 1
1 0 5 5 6 2 7 0 3 4 3 5 5 0 1 0
0 1 5 5 6 2 7 3 4 3 4 3 5 1 0 1
1 0 2 0 6 2 3 4 3 5 3 4 3 0 1 0
0 1 0 1 6 2 4 3 5 5 5 3 0 1 0 1
1 0 1 0 6 2 2 2 1 0 1 0 1 0 1 0