4
15
0 1 2 4 0 1 0 1 0 1 0 1 0 1 0 1
1 0 2 4 2 0 1 0 1 0 1 0 1 0 1 0
0 1 2 4 2 1 0 1 0 1 0 1 0 1 0 1
1 0 2 4 2 0 1 0 1 0 1 0 1 0 1 0
0 1 2 4 2 1 0 1 0 1 0 1 0 1 0 1
1 0 1 4 2 0 1 0 1 0 1 0 1 0 1 0
0 2 2 2 2 2 2 2 2 2 2 2 2 2 2 1
5 5 5 5 5 5 5 5 5 5 5 5 5 5 5 5