4
3
0 1 0 3 0 1 0 1 0 1 2 1 0 1 0 1
1 0 1 0 3 0 1 2 1 0 3 0 1 0 1 0
0 4 0 4 2 1 0 1 0 1 0 3 0 4 2 1
1 0 4 0 1 0 1 0 1 4 1 0 2 0 1 0
0 1 0 1 2 1 4 1 2 1 0 1 0 1 0 1
1 0 1 3 1 0 1 0 1 0 1 0 1 0 1 0
0 1 0 1 0 1 2 1 0 3 3 4 4 2 0 1
1 0 4 0 1 0 4 0 1 0 1 3 1 0 1 0