10
1
2 2 2 5 5 5 5 5 5 5 5 5 5 2 2 2
2 5 5 5 5 5 5 5 5 5 5 5 5 5 5 2
6 6 6 6 6 6 6 6 6 6 6 6 6 6 6 6
4 0 4 0 4 0 4 0 4 0 4 0 4 0 3 0
0 4 0 4 0 4 0 4 0 4 0 4 0 4 3 1
7 7 7 7 7 7 7 7 7 7 7 7 7 7 7 7
2 5 5 5 5 5 5 5 5 5 5 5 5 5 5 2
2 2 2 5 5 5 5 5 5 5 5 5 5 2 2 2