1
5
0 1 0 1 0 1 0 1 0 1 0 1 0 1 0 1
1 0 1 0 1 0 1 0 1 0 1 0 1 0 1 0
0 1 0 1 0 3 3 1 0 1 0 1 0 1 0 1
1 0 1 0 3 3 1 2 1 0 1 0 1 0 1 0
0 1 0 1 3 3 0 2 0 1 0 1 0 1 0 1
1 0 1 0 3 0 1 0 1 0 1 0 1 0 1 0
0 1 0 1 0 1 0 1 0 1 0 1 0 1 0 1
1 0 1 0 1 0 1 0 1 0 1 0 1 0 1 0