6
8
2 2 2 4 4 4 2 4 4 4 2 4 4 4 4 2
2 2 2 4 2 4 2 4 2 4 2 4 2 2 4 2
2 2 2 4 2 4 2 4 2 4 2 4 2 0 1 0
0 0 2 4 2 4 2 4 2 4 2 4 2 1 0 1
1 0 2 4 2 4 2 4 2 4 2 4 2 0 3 0
4 2 2 4 2 4 2 4 2 4 2 4 2 1 3 1
4 4 4 4 2 4 4 4 2 4 4 4 2 0 3 0
2 2 2 2 2 2 2 2 2 2 2 2 2 3 3 3