7
4
0 1 0 1 2 5 5 5 4 4 7 5 5 5 5 1
1 0 1 0 2 5 5 4 4 4 7 5 5 5 1 0
0 1 0 1 2 5 4 4 4 2 7 5 5 1 0 1
1 0 1 0 2 4 4 4 2 0 7 5 1 0 1 0
0 1 0 1 4 4 4 2 0 1 7 1 0 1 0 1
1 0 2 4 4 4 2 0 1 0 1 0 1 0 1 0
0 1 2 4 4 2 0 1 0 1 0 1 0 1 0 1
1 0 2 4 2 0 1 0 1 0 1 0 1 0 1 0