4
5
0 1 0 1 0 1 0 1 0 1 0 1 0 3 0 1
1 0 1 0 1 0 1 0 1 0 1 0 1 3 1 0
0 1 0 1 0 1 0 1 0 1 0 1 0 3 0 1
1 0 1 0 1 0 1 0 1 0 1 0 1 3 1 0
0 1 0 7 0 1 0 1 0 1 0 1 0 3 0 1
1 0 1 6 1 0 1 0 1 0 1 0 1 3 1 0
0 1 0 1 0 1 0 1 0 1 0 1 0 3 0 1
1 0 1 0 1 0 1 0 1 0 1 0 1 3 1 0