1
5
0 1 0 1 0 1 0 1 4 4 4 4 4 1 0 1
1 0 1 0 1 0 1 0 4 4 4 4 4 0 1 0
0 1 0 1 0 1 0 1 4 4 0 1 0 1 0 1
1 0 1 6 6 0 1 2 4 4 4 4 1 0 1 0
0 1 0 7 7 1 0 2 0 1 4 4 4 1 0 1
1 0 1 0 3 0 1 0 1 0 1 0 1 0 1 0
0 1 0 1 0 1 0 1 0 1 0 1 0 1 0 1
1 0 1 0 1 0 1 0 1 0 1 0 1 0 1 0