6
4
0 1 0 3 3 3 5 1 0 1 0 1 0 1 0 1
1 0 1 3 3 3 1 0 1 0 1 5 1 0 1 0
0 1 0 2 0 1 0 1 5 1 0 1 0 1 0 1
1 0 1 2 6 2 1 0 1 0 1 0 1 0 1 0
0 1 0 2 6 2 0 1 0 5 0 1 0 1 0 1
1 0 2 2 6 2 1 0 1 0 1 0 1 0 1 0
0 1 0 1 6 2 0 1 0 1 0 1 0 1 5 1
1 0 1 0 6 2 1 0 1 0 1 5 1 0 1 0